7
11
🧱🧱🧱🧱🧱🧱🧱🧱🧱
🧱🧱🧱🟩🟩🟩🟩🟩🧱
🧱🟩🥚🥚🟩🧱🧱🟩🧱
🧱🟩🟩🟩🟩🍳🧱🟩🧱
🧱🟩🧱🟩🧱🧱🧱🟩🧱
🧱🪹🧱🥚🟩🟩🪹🪹🧱
🧱🧱🧱🧱🧱🧱🧱🧱🧱