6
13
🧱🧱🧱🧱🧱🧱🧱🧱
🧱🥚🥚🧱🪹🍳🧱🧱
🧱🟩🧱🪹🟩🟩🧱🧱
🧱🟩🧱🧱🟩🟩🟩🧱
🧱🟩🟩🟩🟩🟩🟩🧱
🧱🧱🧱🧱🧱🧱🧱🧱
