7
12
🧱🧱🧱🧱🧱🧱🧱🧱🧱
🧱🧱🧱🟩🟩🟩🟩🟩🧱
🧱🟩🥚🥚🟩🧱🧱🟩🧱
🧱🟩🟩🟩🟩🍳🧱🟩🧱
🧱🟩🧱🟩🧱🧱🧱🟩🧱
🧱🟩🧱🟩🟩🟩🪹🪹🧱
🧱🧱🧱🧱🧱🧱🧱🧱🧱